R 1200 800
NO ./textures/wood.xpm
SO ./textures/stone.xpm
WE ./textures/brick.xpm
EA ./textures/metal.xpm
S ./textures/pillar.xpm
FT ./textures/brick.xpm
F 2,2,2
C 150,150,255
1111111111
1000222221
10000S0001
1020000001
1000222001
1111111111
