R 1200 800
NO ./textures/wood.xpm
SO ./textures/stone.xpm
WE ./textures/brick.xpm
EA ./textures/metal.xpm
S ./textures/pillar.xpm
FT ./textures/brick.xpm
C 150,150,220
1111111111111
1000000000001
1022000000001
100000N000001
1000000002001
1000020000001
1111111111111