R 1200 800
NO ./textures/wood.xpm
SO ./textures/stone.xpm
WE ./textures/brick.xpm
EA ./textures/metal.xpm
S ./textures/pillar.xpm
FT ./textures/brick.xpm
F 100,220,100
C 150,150,255
11111111111111
10000000200001
1000S000000001
10000000000001
10001010000001
10001010000001
10001010000001
11111111111111